111111111
1000000E1
1P00C0001
1100C0001
1000C0001
1000C0001
1100C0001
1000C0001
1100C0001
111111111