111111111
100000001
1000C0001
10000C001
10P000001
100000E01
111111111