111111111
1000000E1
1P00C0001
1100C0001
1000C0001
1000C0001
1100C0001
1000C0001
1100C0001
1100C0001
1100C0001
1100C0001
1100C0001
1100C0001
1100C0001
110111001
1101C0001
110111001
111111111