111111111
1000000E1
1P00C0001
111111111